THE BEST CHRISTMAS PRESENT IN THE WORLD
Junk - discard or abandon unceremoniously.
Scorch - burn the surface of (something) with flame or heat.
Veneer - a thin decorative covering of fine wood applied to a coarser wood or other material
Brute - a savagely violent person or animal.
Huddles - crowd together; nestle closely
Rousing - exciting; stirring
Muddle-Head - Confusion, confusing and feeling confused
Recognition - identification of someone or something or person from previous encounters or knowledge.
Scruples - a feeling of doubt or hesitation with regard to the morality or propriety of a course of action.
Trench - a long, narrow ditch.
Parapet - a low protective wall along the edge of a roof, bridge, or balcony.
Schnapps - a strong alcoholic drink resembling gin.
Marzipan - a sweet yellow or white paste of ground almonds, sugar, and egg whites, used to coat cakes or to make confectionery.
Matron - a woman in charge of domestic and medical arrangements at a boarding school or other institution.
Drifting - carried slowly by a current of air or water.
Suffused - gradually spread through or over. 

HOW THE CAMEL GOT ITS HUMP
Prickles - a small thorn
Saddle - usually made of leather, fastened on the back of a horse for a rider
Yoke - a wooden crosspiece that is fastened over the necks of two animals and attached to the plough or cart that they are to pull.
Trot -  run at a moderate pace with short steps
Dust-cloak - Something maintain Secrecy and privacy from others
Remonstrated - protested/complained
Hindrance - a thing that provides resistance, delay, or obstruction to something or someone.
Puffing up -  if a part of your body puffs up, it swells painfully because of injury or infection

THE ANT AND THE CRICKET
Accustomed - customary; usual
Crumb - a very small amount of something.
Dripping - very wet.
Trembling - shaking or quivering
Miser - someone who is not generous
Quoth - said